11111111111111111111
10000000000000000001
10000000000000000001
10000000000000000001
10000000000000000001
10000000010000000001
10000000010000000001
10000010010000000001
10000100000000000001
10000100000000000001
10000100000000000001
10000000000010000001
10000000000010000001
10000000000010000001
10000000000000000001
10000000000000000001
10000000000000000001
10000000000000000001
10000000000000000031
11111111111111111111